S,_,_,_,_,_,_,_,_,_,_,~,~,^
~,~,^,^,^,_,_,_,_,_,~,~,^,^
~,^,^,^,_,_,_,H,_,_,~,^,^,^
~,~,^,^,_,_,_,_,_,_,_,~,~,^
~,~,~,^,_,_,_,_,_,^,^,_,U,~
^,~,^,^,^,_,_,_,_,~,~,_,^,^
^,^,~,~,^,^,_,_,_,_,_,_,^,^
_,_,~,~,~,~,_,_,_,_,_,^,^,^
_,_,_,~,~,_,_,_,H,_,_,_,^,^
B,_,_,_,~,_,_,_,_,_,_,_,_,^
_,_,~,~,~,U,_,_,_,_,_,_,^,^
_,_,_,~,~,_,_,_,^,^,^,_,_,^
_,_,^,^,~,~,_,_,_,_,H,_,_,_
_,_,_,^,~,~,~,_,_,_,_,_,_,_
_,H,_,_,_,_,_,U,_,_,_,_,_,_