S,_,_,_,_,_,_,_,^,^,^,^,^,^
^,^,^,^,^,_,_,_,_,^,^,^,^,^
^,^,^,^,^,^,^,_,^,^,^,^,^,^
^,^,^,^,^,^,_,_,_,^,^,^,^,^
^,^,^,^,^,_,_,_,_,_,^,^,^,^
^,^,^,^,_,_,_,_,^,_,_,^,^,^
^,^,^,_,_,_,_,^,^,_,_,_,^,^
^,^,_,_,_,_,H,^,^,_,_,_,_,^
^,_,_,_,_,_,_,^,^,_,_,_,^,^
^,^,_,_,_,_,_,^,_,_,_,^,^,^
^,^,^,_,_,_,_,_,_,_,^,^,^,^
^,^,^,^,_,_,_,_,_,^,^,^,^,^
^,^,^,^,^,_,_,_,^,^,^,^,^,^
^,^,^,^,^,^,B,^,^,^,^,^,^,^
^,^,^,^,^,^,^,^,^,^,^,^,^,^